dmm: scj tkm
fhg: shz ffh xlh
gmk: djg zdc
vpv: vlk hcl qpd bjr
rrf: xqn rzg
hct: lck zbl
mfj: mmk mjz cxg
hsp: ntx
fqq: hcp
zvc: pxl hdk
vhx: djx xlh pkk
cbn: zhv xdj ddf
hjg: lzr lhj gfs ngz
lsp: tsb
rfl: ltl jtj
qcn: hhl tld xhm lth xjp
qph: pkp
lfh: lzh jrf
vsf: qbz ghf
shq: qtb
qbp: cfm tfh gkb
bqp: qxn
mqp: qfk czj
hdr: vhr cmf jrn
ngb: rhq pcs hlh shv fqx lck
fds: sgg ndm
qdx: dmr ttr xgv mzh
mjz: vpl
zlz: gmd dzs mvq msb
zgr: xtp rlc smr
xmb: xdt sft ffd
bmz: ksd
rsm: hct rrv
bdg: kkz ddb rhq qbp
clx: tfh
jbk: zkk ddl hhc rvb
xnd: mks mhf
xvk: ckk qph krl zrf
tlz: ppn sfg tcd
tpf: jpm
lnd: vlt shq
rvk: zdx nrm
hcl: qlc dqg mvq
hjt: xxx
pbh: zgr dqn nks
mlg: qbj jtc jlh fbx
kbz: qvg thk knj qtb qzb
tkk: qhd sqp tbx xqk
nkp: psg mdg lrd qdt
lcf: kmh stp krq
qcl: nkh gdt vdj tfp
hmd: pnm ccf
txb: pmd lvv dnc ttm
kqd: jzb kmm nhv jqv
vlt: hfr
jrz: xzk vvd xsn zsm
hbv: dsp
hkj: bmp
qch: qtv mkq
szf: kjs qnh fxz ltt kpc
nfb: tjg
lck: xpz
bjj: jbs hvf pxz tqf pnb
bfr: nlp bjt fjz
hhc: fsx fzl rdx gdt
qnl: gng
cpr: rsv ztt kcc
txl: lfh shv
kfl: nfr cjz
bzr: srd bkc slv nrn
kdf: xdn frn hjt vmx dgv
mvc: hch nkv tkz
hsr: vfc
nkh: dvf kmh fnp
vfj: mnv mkm bfp pqx qkj zxz
pvq: nbn krq lvd zdh
trv: vlt
cpp: ntb
ngg: krq ttz mrm
hkf: bff jmx rkc
cnp: hsh mfh qmz
hcx: bnx vpl vxk qlc
hhp: fcv xzz vdp
khl: lgm qbd
szk: vxx ffg srt
rbb: htd rxq
vkx: sqx slt qlc
sll: xxz rgc dbf xqk
thv: hdk fgs
krn: ztt nkp slv
krb: mms xdt vxk dlc
hfd: fzd xtg
tgb: srl qzv dlb
fsm: gbh
sql: tfx mbz
lbg: mdf kbz
tbj: fvb kft bnd flz
gcr: jkn xdc
djj: dmm gsg zhv krq
klx: nrz
kct: flz zbl qqn
gmh: nzf
nfv: thk txt zkq dmf
dzs: hrn
fbf: qfm tcd jnk
hst: dpt mmb lch gfn
tbx: bgx hvf tkz
tss: kvz
vpn: scq fsv
dkk: tcq
hvx: tbv vrl sdj
bpg: lvv bbx ddm pgb
kxj: fds hhl
ldp: htq xqk lsd cdp
vgr: dfs
sfl: cdp dvk ctv gcr bln
sqv: cqp xxx lkm
pnh: clx hkp tpf
hvt: hfr dgh kbx
brn: jkm czp jsm tsf
drx: pnm rvt lss
fvb: shv
jpp: jbh nqr lbx kgd
ptb: dmg qlr qnj thv sxs
zkk: tss kxv skx
vrf: fjf dpg tlh xhq jzh
gjq: hcp
hfp: lfg jvc
qsk: fqv bht drf jvc
fnd: lsd vsm kft
hlx: sxt lkm chm
bdx: kmh
drp: pbh hmj vdj xfj
pfc: scv cpr tkl
cgg: kkj bkt
tvf: gfx bjt
nxg: tvk rnt vjx qhd lxv
fbz: pxg mks pbq ksr
tfh: gng
chm: zhj
kml: fgp tsb tqm dmg
xpg: zgt
fjf: gvh jpm
mhb: cxg jbm lvv gmk
zjq: rsv
hxt: qqc cjr dvh rrv cth nxj
hgr: vrt kmm jlh szv tkf
gch: sgf bkd grx gms
hvz: mdg
fjm: tfx kpm
jvl: npk sgp sxs qnm
tlh: zmh
pnx: bjt tss dbq tbh
mns: lrz flm
lns: qqd gth cgg
ddr: fhg bjj mhd ltp
hml: pkp hxc sqk xqk
tmm: rxq hcg qqc
qbv: lcp mbz dph
jbr: cbg qdz txf mlx
dvf: jkh
qqn: qtk
vsd: hsq csz fcj ldd dxk
bmp: xdc dkl
qbs: xjt lgx lvq ksd
tnj: mnv krl rcd
hdm: kpc lmd
vxx: fls vvx zmc
dvt: vgr
mst: lsx tkl mkh gbc dff
qjf: djg gmd psq pgt
pkk: svf mtc gmj
tfq: rml ppn lmd
gjv: cpp ksd tjj
jnq: psm fls xxd vvs
zxb: rxp qph zgg
ktt: rnr jrf xkl
tsl: fbl jvh xzk
nnz: vpn xht tdf lth
dfd: jbf mcj xpj tnj
jbm: kdh
ktp: kfl lnd tlh
gzq: dfs
ctn: pns kmv vfc
csx: jdc cnr
vkl: vkz
rcd: dbj rfl ppc kfz
dfl: czn hkj csz zrd vlh
hmh: zqm qdt fbk fxq zgt
rkb: jbm hjc fsl
jfs: dxf qfk
ltt: jzb
cgk: fmx
lxd: mtc vzd skn pzc
gsh: fqx rhq
rsf: xrr
gvf: pbq xjf fpx rfl lxv
mgc: rrv fcj
mfm: jnk lsp klz
vpl: psh
kfk: vkz nhb htm kqx
cjr: pmh kkx
tth: scq mhv nbs qdz
zdq: hdl cjz vcj qvh
xcn: pdc pkc szk
dxf: bkd htm
jdp: nkm nhx mzs zzx lzr
nbh: cvs svx kxg bzt gmm
zkv: kgd pdf
dpg: vkh fzb btt
pkc: mlx txr
cns: smj scv
jvc: gvh
pzx: nsq czn
rqp: jfd
cqp: zfk fkf
bxb: jbm vpf tql kgd fxq
rvm: hvq pqq pgt dxh
lrr: msg xst
zft: tqf lbg
rjm: lbx xjt nbn xnx
qdk: kcf zdl qtv
bnd: hch
vlh: bvj ddb tls srt chv
kbl: zjq qxn fxq jlb hnk
xsz: tcq nmr hsf czn
npv: vmg rgc bkp
tcd: xqn
fxq: stp
fht: rbc pth lfd vjs
hpr: sft
gfq: pfd gbc hsr
vrz: ffg rdt htd kxj lhg
tgn: kbx
qkj: lfh zls
csz: tcq vjx
zmh: pkc cfn
dgs: hkj sjx vmg vfx txt
pdc: ffb gsr jhz
xhq: bcm pmh
kpx: phx gsh ldn
gsl: sbr xdn tqq hvk
fkq: bqp rtg
tzd: klh blf pjz qqd
jlc: gtt vkz
fkx: vzd qch
dzt: bzs qrm rkb lvb
rzc: hsr bff jzb kqx
sps: blg gbh dfs mck
mbd: lzh qqh hxt krl
fhn: czr dzs pdl
krq: mfh
trn: kcf dvk xzg tjg bhz
gfr: zcr mcj gmj
dvh: jtj mjv rvf
mcx: vpf
xzk: pbj
qrc: nkh dtg zqm scj
slt: kfg fhp zkv
nhv: jxj pns
xtp: mcx xzv
xkl: gsr jkn zlk
xzb: jls
hhf: qtk
npl: hgb ctv pzx
qjt: fcv jct sql kfg
skn: tfh msg sxx
ctp: zjx tjm xtg kxz ldn
xcf: htr ldk
mkm: hvn nkl xdn
mrt: vdj
jrq: bzx klv qxn
rdb: tqq rcg gbh bdg
gxx: qqd sbl
zdg: qzc clx zmn
lvk: tql fgd pcz shl
bvj: nkv
jtc: vth jmx
mks: qtf dxk
rxq: qrh
bjm: tpn
hqc: rdj fqv
pbq: tqf lzh
flc: sbl nsq hkh dmk
ncf: bgn dxk lxv
scf: xfl ltt
dlh: tdf zfk kcr dbf
mrm: qnm psg mkh
vcj: jpm
kxg: pnm jpf
kpd: fsx vxk pgt tcr ntl
pcd: dfs sqf bfp
jxj: bzx
jms: klv bjr dqg sfg
pcf: ssg dqf kcf gxx
mjd: fcv fsx vlk
jbt: xxx sjr lfg
kts: kqx vqb pkq qhr hmd
zcr: rfr
bvb: qfr lrj xjf
cph: hgb mdz
khj: jhl qfq srq nkt
fzs: kmp dvh rnr
kkn: vpl jlh
cbc: zfk dgr mhd
sqk: rnt vps
hxc: kcr xvc pzc
zdj: vcr kjj lrj
gbq: mrm fsl
zxr: vdp
pth: jtj klh pzf nlx snq jhl
hfb: gcn jfs mms qsj
xkx: zvv zxb zdn
qvf: hvr mpq
vvd: qmz ghf ntn
hcq: rvf rgb
mdm: xzv fss lhj lsx
fjt: dxh fdx mrt zfz
ndv: dsh hxr kvz cmj
fcj: qqd mdf
rpr: zxb qnl zmn zcr qch hbv hsp rbc
jbs: vlt
fxz: qlr sbv kcc
hbx: dhz hbv bvb grt knm
bjp: nhq vkl xzb bfr djh
vps: sfc trv pdc
ddm: pdl xqn nhl
vtp: vnn rgb zhj jjg
vdj: cvp
pmz: cqd rsg zbd qsf
nnm: psr rcg fkx hzb njz mhr
rln: vps rdg ljs fzd
rkc: ggf fxx kkn
rxp: mdf
lrj: kvl qqs
sjq: kbt rxp tvz cps
hnb: vxm txg ltt dzs
jtf: fqv rph ctz xcf hcq
pnm: psg
dmt: ljs bcr rnt ldn
ghc: mkk
sjl: xjp tgn lhz cgq
cmf: dgh
xdj: xvn sxk
gdt: mzx
vkp: pqq
nst: nfb lvg qmp
qrv: dph qpj dbq nlv
qpd: lsl svx rqx rml
xnz: htm dzs ssl hrn
bcr: xgv cgz bxf zfk dfr
jdc: jkh
vhn: hch jkn qbd nst ntx
hpj: fml
jkx: qsj fgs
mdg: bkd
fsg: ssg lxv grt htd
zvt: cvb bnp
lfs: tcd
rrb: nkv hkh qsf
ztc: qnj gts kvz
cfn: cps
vbm: vcj tvl lsd fbz
vhd: xpg
czm: jfk
dtm: qrh
gpk: bqp knz hpc pcc ltn
xtg: srq
fmj: kpm
nsv: nnz bhz kjt nbc
ftg: zls xtg xpl jvc
bkm: rqp kfg vgp ldk
qzc: sqf
gkl: nhv gkj djh
nrz: hkh rph
rsp: zpr cmr mvq nhq
dff: kfk cvb hvr
xmj: bms kbx ddv xst
mnj: vdp rqx bzx
dxz: vfd hfc fgq zxr
pnb: lfh
bbt: jdc xkz
frn: vjb bvk jpm hqc
tzh: bcm qqn csd qgp snq
cxq: fzd
blg: fzb
rlc: hcs fmj xvd lfs
svf: lth vlt htr
kxv: dxn czr
gvh: gth
lhj: xsn htl
hfc: pxl qzv cvp
tvl: xvm pzc mhr
pcj: bhk bdp xrr
gsr: nnh
lxn: tbh rkv ksd ggf pbj
qdg: jlb hrl plb ggk
jts: sgp zkv czm xzv
blt: xtp kxg gfs gtq kmv
bfp: pcs psm
jmg: lfs fzl xnx
knj: mdz tcm
sxk: lnp
qqs: qbd
ncm: pmx hdr pxg
fgr: fds pgv hdg
mmb: jgc xhl
ldd: vgr
dbj: hkp rgb kkj
rxt: cgg zft rnr ldh
jhf: xpg
lss: ddl qsj
drr: sfc
xxz: kqp lhz shq
bhk: lgm sjh xfb
grk: zmc xrr vjb
sfq: qrh ldd nzf
jfv: fsh lsl hsh
lgt: xxz kxz fcj bgx
hpf: psr fdh tmb bht
qnh: mkh
prp: hvd
jjd: npl rvf hlh dsf
lzv: zvt fsh xzc llt fjk
qcx: fkx nrm hbx kxj
rcl: qrq hbq qvg
rcc: ntl jfk srl
pgk: mkk tkm
dxr: lbx fgq qsj cfr
gzm: sgq tjg hch nfj
dxn: znk hks
rnc: mkq mzh nhn mrs
svc: htd mcp dvt
fxk: mjd ddf
fhj: mgc pjz grt bgx sjl fls shz
qjp: ckx lsx dqg
mlz: cfm gzq xjp
dbc: kpj flq ttm
gcn: mbz rbs htl
jhd: jbt kbt blf xzj
cmg: gfk vzf ncf gvh
cjg: vgm fkx sfc vhx
vdr: hbc sqv sls ndm
mfk: kdx bpv sxk zmm
qjc: vzd gth dtm
ntn: lcs
smj: bcg
bsq: fsm tmm bft ghp
cgz: lkr
jrg: gzq gpm bkt
qrm: gjv
vzj: tfq qfk mrv
tfx: xzz
xxs: vhb fkq bzs vzj
gdv: zft nsq pzc
xnn: dmg fxm hcp
ppn: hks
jzg: hvt htr
prh: btp lss xvn xfl
zgd: xht kcd dfk fsv
mcg: qds pct mkh gmm
cqs: klx tls qtf pqg
mgx: ckx jsm jfk
zxz: tgn fcj kzh zmc
vhg: tpn jvh jlr zcz mfk
dht: dcr vhd smr qpd
kgl: mrs mmd zdx xjq
scj: xkt
gkj: pdf cnr
std: mkq kcn
xmc: xjq pgv
jpf: fbx rzg
fzl: lcp
hsl: bkp
kqx: fch
vpm: pjz bcl
dfr: grt jnr rrb
xtx: tcc hvz
kbt: kqp
jhs: ldh chm nzt
vmz: fzs lmb zdg
bgl: zch zdl nxg dgz
rqq: tgb szv dnc gbq
skd: bcg
cfk: zmn mrs bgc tls xkx
mdv: lkh qgz bkm tcd
lsr: hsp cfn gjk
fxg: bgc lkm fmt
hdg: gkb
lkh: dcl lsl phf
tkf: psh
rnr: qzb hsf
sbr: vzd rnr
zmq: txl tmd kbt kcf pgh
hdh: hzr ddv knm vgm
sjh: rnr bnr
rgr: ngm xkt bzs vzn
qdz: prp
tkm: pxl
ppz: cfr nrn fhn fbf
mhf: fkf lsr zhr
fch: znk
xvm: sqf ktr cjz tlh
pgb: cmr jnt
crk: djh mmb hfc fbl
gpm: fqx
ltn: pqf gfl
kpn: fmr qrq bqc
mgq: klx vpn jzg
shm: sdx pqx
fmg: brb csj fgp tbv dbq
lkq: vjs qtk cdp jqf
ckx: pqf
mvp: zrf mmr
pcs: kcd
qzh: mgq jjg hcg tbz kft rkf
tpc: gth hfp hct xcn
bcl: mvc thk
ljj: knj phx rrb
tqp: dsf qdk jpb tpf
nmt: xrr mbg tpd zjx tmz
pct: tcc gfn
khr: gdq fzb vzf xrd
sjx: zrd qqd ktr
lvg: xzg
slq: klz lcs hvx gfl
ldn: tpf xjf
nhn: fmr qqn zlk
dmk: xpz
smd: nbf zzx lsx kpd sxk
zgg: prp lkm
qbj: mxs ghc
fqm: vjb rnt qtv hvf bvj
jzn: lcc mch pbj
bmq: sqp sqk knm
ckk: tkd jnr
rbc: nxc txf
vjz: zdj rdg pcs srq rhr psv
xfj: rkv pnm xnn
qtb: rgb
tbh: vhd
xnx: klv hdk ttz
dgv: tmb qbp
zqg: lsx svx jbh
sqz: ksd jls qnh
zkq: sgg
qxn: lnp
fgc: shl
gxg: nlp bdx svx
fmt: xfb mvp lth jrn
qqb: dfk nsq
hhl: rrv
xzj: klx hsf
btp: fss fsh hmj
hsq: vvs sfc
kvg: gnc fml bxb jdc mrt
djx: zmh dfs dlk rxp
xvf: llt qds pqf mqp
pcz: nlh grx kmm
zjx: pqx kfz
bnx: trr
tjc: lvg khl qtk
qkb: qnl lcg ncm mck rln
zmm: tjj dps fmx
vgh: zqg bkc rpj dqm gms pvh
hsm: jtc thv smj
dsh: lsp hdm
kcn: jrf nfr
bsm: rrb ndm bxf
xsn: zdh qxb
cfc: rdz bfh dxn hvm qcl
dxh: jsm pdl
sls: ldn gsr
zlk: kcr nzf
nhq: xhl fbk
tcr: kpj qbz mrv lcp nkm
fmx: plb
ngx: xlh hlh zgg jtj
mff: tkl mzx vxk
jnr: sqf
kmv: xzb
mkk: ntb
mdp: tqm
bdp: std hvd
nkm: cgk vfd
sdx: dmk tjc hfd
vrt: qrm ntn kxv
lff: cbg dbg htq
lrz: dph fjz
zzl: qkl xjt ggf
rck: hjt mlz vvx ddb
llc: qfq bmq hsl
bkc: nhf tqv ngz
hrl: fgs xfs fsx
pxg: jhl
csj: bjm xsn nbl
lxb: stc vvs tgn nsq hbq
vmx: ntx qtv
pxz: mhd hxj
kjl: ppz qjp mzz nrn
xjt: rrf pgt
vkn: ztx mcx hvr vdh
lcg: hkp xpz txl
ttz: ccf
vdh: dps
brb: scf xzv xqn hpj
gmj: xvc bft
ffg: nkl
lzr: ngz jpf rkp
snm: mlx fnd lfd
hnj: gmh vmx xjq
bff: bnx crx
mlx: nnh
kvz: lsl
gxk: hvb smj dqm zpr
ths: qtv zrd
gfm: cbc mnv hxl npp rdt
smn: brp cfm bcr hbc
npp: rsf fdh hvn
xfl: bzx skd zqm mmk nrn
knk: mhd fvb jjg cmf drr
nhx: nbh gmm crx
rdx: xjt kmm dmm
mmd: tjm crs
hmf: jcx fqq ttm xsp jst
xvd: jkx
ffv: zhp msg
mzh: jhb pnh pkp
zll: cxg zvc rqp ddl dqg
fgv: pkq gjq xzz jpl jzn
njq: stp zqn nhf kpc
pvp: mcp ctd jdl gbh
rpj: gch lvt
tdf: sbl zdn
lcv: lhz qqb shv rdg
tqv: jkh jls qmz
rfr: qzb pzc hsp ctv vvs
cls: scq zrf
ssg: mhr vnn
qgc: rcl mvp ltp kvl rph
tfv: ktp rlt vhr kfz
jmx: bgm
kpf: tbh xvb jqs fxz
hzr: ljs lff cqp bht
mvn: jhb bgc hnj bqc
hfv: phx xcf rkf vdr
sjr: vqv
hfr: ckq
djd: fsl vpf jcx lmd
mcj: ctv txr
zdx: zhj ddv
nkd: vpm dqj
sdt: zls fdh sqp vzf
bcd: rvt rvb grx
zdl: xdc
jdx: zmc
qgf: mvc slh zkq czn sjr
fxv: tvf vqb fbl pnd flq
zfz: bzt jlh
mbg: hbc zsr
qnj: bnx
rgl: ltn klz zfz xsn lpd
qmr: ths ffg cgg rfr ckq
zss: dmf cgz xrd kkj
vtq: ldk qsf tkz
ndg: xmb vkp xkt fhz hpr
mpj: lzh
lqx: phf npk
sxs: hrn
pkb: nks fnp rzg gms
rlf: kpm lvb pfd pcz
mzz: phf gmk sdj
rdg: xjq
pqg: cqd
xst: xxd
pmd: lsl
bmt: jrn xbt jbs cfn
fdh: ffb gxx dgz
xcl: dlx dlc jfq xzc
xtk: qhd lxd rhq jhs
kjb: rpj csx dsh hmj kpc
bjr: ngm lsp
nlx: txr
rvt: rqx
nhf: trr
nkt: lfg
jzh: crs lns
tzj: cmj gfn
dpt: jxn ngg cnh
chv: dlk qmp bnd
nrs: nfv gfr kpx bjv
nbn: fhp rdz
zch: dgs hbq zxs
xkj: qqd vjs vtq
ktr: klh sgg gvh
fnq: bcm tcm gkb dkk kcf
jxr: tmb cdd
tqb: fml cvp zbp mvq
kvr: xjt sdj jdc
psq: clb bdn pgt
hrb: rrf qgz dxf tcb
dmr: mtc mvb hfr
gfn: cmj
kkx: qph bhz mhr
hsh: qbr pqq
lpd: tzj grx rbn
sqx: zct fjm
kcc: ffd
dnm: jlr bvc jpc tjj jpf
dbg: khl xjf hfd
nfj: czn kcn gmh hsf
xhg: tcc zbp smr rqx
hcs: lrd scf
lhg: jhz
gmd: fbx gfn
dlc: ghc
fgt: sql lcs jsm
nbz: tbx mcj mhv jbs
zxt: skd fml gfs
xcx: sgf gbq fch fdc
ndp: gjk nfb sfq vpm jdx
hxr: plb
lch: nlp lvt jpl
pcc: zrc ggk hcs
vhb: lcf jpl nkm
pdf: fgd
xpl: nbs sls
svx: ksd
gfx: xvh qff mfm
vmg: zhj nxc
lmr: vrl pfd nks fdx
zls: hxj
crj: xkj tkd zxs ptt
bgn: sbp kfl pcd
qgr: rdz bbt vsf ntb pgk zxt
bgh: hsf nst std pnb
tls: trv qrq
sgq: xpz
gfk: ktt zsr bcl
brp: rnt jhz cls cxq
zct: nhb
bcm: mpj
fls: hcg
xfg: ltp cdd vvx bpk
spb: qnj sdj htl
mms: lqx kpm
nzn: ntl pcz lnp jkx
lvd: xfs sfd
fxm: jbh gfs jxj
klc: fkq mfn fqq qds djd
rml: dtg
btk: vxm vkz pkq pmd
bnr: jhz
rkn: gdv hml zhr ljj bnd
nrm: hsf psv
cbg: qfq gng
fhp: fhz ctl
ztx: mns dqm
nnh: srq
hvk: blg rnc flz chm
fdx: ckx jlh
qbx: thk ldd dgz nkd
lnp: zpr tsb
pgj: tpn xzb fsh
tjg: dgr
pns: fcv
bzt: bnp sft cmr
vbt: tjg xxx kkz fpx
qkl: qnm
htq: fqx lkq
zqv: tmz lmb lff hsl
dcp: bbt kfq jnt
vvx: bxf
srd: xhl
jjg: lkq
sxt: nbc nnh
nhl: ghc gjq bdx kdh
qlr: mkh
hvm: vkl xvh zpr
mfn: fmj
vzf: zfk
gtq: xjt lvb
csd: dgz
fzb: qqh zhr zhj
zdn: xbt kxh
jlr: hmj mpq
mtx: hvm kfq srd rdx skd crx
hng: jlc lsl clh kdx tsf
jdl: nfb
clh: jqv nhq lvb
pvh: vzn ssl
hsj: pbj xvb psh
qdt: mdp jpl
jfj: hxr crx vbg gfn
rrv: lgm
klz: rvb
zvv: jkn
xbt: sjr
fmr: xmc
nlp: qff qcj
pmx: hdl hcg gpm ttr
thg: ctz txj xvc zrd txq
hvn: phx tjm
cvb: jkh
xqn: hvz
tvk: nkv kxh nxc
jbh: dnc
ghp: gzq htr
vdn: zxr fjm jhf mgj
vvr: gkl hrn sgf
xjp: ldd
ctd: lxv mjv xhq xpz gth
vgm: msh zfk lfg
sqp: vfx srq jzd dgv
qfk: xcj bts trr
zqk: bgm jgc mnc
pbc: tql hpj sfs tkf
mpq: lrd rqp
pgt: pxl
zjm: sgg jrn sxt ghp
qbm: qkl fss vkl zvc
qfm: vth nrd
bqc: mpj nkl
drf: jnr msh zmn snq hgb gdq
jcb: hdl shm zfk qbd
xzv: mpg vth
gdm: rgc dtn bdt ztj
tbv: psh lcq bkc
rkv: kmh
hnk: txg
xgv: mdz dvk
fjk: sqx cmj hks hpr
xdn: xst
hxl: fcr dbf bgc gfr
czp: gts dtg jsm kdk
rkl: fsl jct xhl pqf pgj qfm
tmh: gzn pfx pgh fhp
jxn: kfq ddl
ssm: crk lvq nbf sfs
sln: fhn lvt pgh
scd: dbc qhr ztx rbs mzz
jqs: lcq
hdx: mfn ltv nct tfp
cdp: nfr dtm vjx
hjc: dzs
cxg: qbj
sgf: hdm
rkf: pqg ffb
srg: hhf nnr zdg jhs
ddl: rkp tfx
dcs: vdp vkp zct xfp
rkm: sqz mxs klf cnh
pnd: bqp xzz hkf
ncd: gsh xdc xkl rsf
xxk: txg fbk tkm sxk
nbl: pqq tkf kdk
kbn: jnr qbd rmd nkv
fgp: klv
dkg: kzh czn lrs bvk
mtq: nks cgk dcl bnp smr
kjs: hsr pgb tsf
sss: jfv cbn pmd scv
mhv: xvc mrs szs khl
bbx: qbr lvv ngm
rsv: xvb slt tcb
vfd: fmx xkt
chn: hxr sln mch
dgh: sbl lhg
lzh: krl
mgj: npk bdx
cgq: fqx xxd
czj: vqb rbn qlr
ctl: cmr
mrr: jqf mmr slh rdg
sbp: gcr mmd mdf fdl
dqm: xnx
mpn: cns cvb txg
ppc: txf fzs
nxj: tmz jdl mhd
rdt: vzd tvz
rjq: jpb szj kmp vvs dgs
pzf: kfz rgf
zsb: gsr ffv vnn lkr
pgq: xzj jvc ntx
xfp: ghf mvq dvf
tcc: lcs
qqq: ppl qvf jxn dhq
bzs: znk
cgn: flz lrs pgv dmk
dmf: cxq ldh
ffq: ptt npv lsd zvv
jhb: rgf
bbg: cgq knm zhp vnn
pdl: mkk
rnt: zfk
vxm: djg
kmh: sft
dnz: pbj skx vxm hhp
hvb: zxr xkz sgp
ccf: bkd fgq
bpv: zrc mdg
bxf: qrq
bcg: hxr
gjp: vjb gxn ppc rhr
rmd: gbh rvk qkj qzc
tbz: tvb dgx
vgp: zbp ntn
dlb: kpj qmz cpp
lcq: hcp
gsg: bgm xjt zfz
ctz: zbd
bfh: mnc tsf xcj jkm hvq
sbb: rnr mpj dfk
njz: rgf nlx tvz slh kjj
hhb: kkq mnt fbl fxk lrd
cfm: szs
gqz: rcd vcj llc zsr
rgc: ddb bnd mtc
lvt: ppn
hgl: bmz mxs rkp krq
msx: vsf mmb vfc
bbn: msb jcx gfl jhf
lbx: vhd cvb dlc
hvf: cfg
vrl: dlb
xzc: mpg fbx hdm
mpm: zvv nkt jnq rvf bln lrs
hmp: fkq kmh ctn
gms: dbq
jmq: hkf jvh ghf
cqd: tvb pzf
hlt: scq fsv zlk jhb
rlt: xdn std dvh
mnv: kxz kft
fdl: cbc lrr bvj
sfd: bmz shl lfs jfk
jfq: hdk gtq npk chn
cxz: sqf xht
lkj: nkh kmh mgx plb
fdc: ngm bcg
klh: xdc
rqr: jrq sgp ztc psg fxq dnc
gjk: fmr mvb
nqr: rdz pvh psg
xbc: xfb knd zcr hdg
ctq: hkh pqg tgn lnd
bdn: vzj dph
npm: pdf lcp kkq zkv zvt sln
vfx: ltl qqs
gjg: sbr hlx lbg snm kjj
qfr: pqx
jbg: fgs hcp
ztj: tdj ngx xjp
jzd: hfp rhr lfh mvb hvd
sxx: hhl txr
dgx: tmb hfr qvh
zbp: tpn
dxk: kvl
jxg: knz jzb ntl tfq
ppl: xbj trr zrc
nct: lsx
xrr: vjx
vgt: jkm kcc nrd zrc
mjv: krl
gqm: zjq tvf rvt cnp ggk
ttk: mbz tzj nhv rcc
rdj: shm clx
gnc: pct msx mpn xcj
jmh: nct qkl cgk cpp
nnr: pcj hsl pnb
fxx: fzl jzb kfg
dbx: phf xdj mqp dmm hmp
pld: jmq zsm tss ghf txg
tgs: ltl mvb nbc
rxd: qfr csd dmr pkk dfk
jst: qbr mvq fsx
dtn: cjz szs tvz
qcj: ttm ggf bjr
xpj: qfr qqb cph
txj: bjj hgb dkl
xfv: qrh nzf kvl cdd
gdq: lmb hbq tvb bdp szs nzt sxt
skz: bgh qjc sbr cqd
cfg: xxd dmk
mck: fvb
mng: rsf dqj vcj
ttr: dfs szs
hzb: cmf mlz chm
qqh: ljs tkd lsr
jnk: ffd
xkt: jct
ntl: mjz
zbl: txt vqv
qxb: qmz bgm
qbz: zgt
xlh: mmr
vzg: mcp dvt ddv hvt cfg
vbg: mgj tkl nxs
xsp: qlc mmk jlc
tcj: jkh vxk bjt lhj
xdt: djg xkz
kkd: drx mfn rkp fss llt ddm
zhr: drr bkt
hkp: ldh qrq
chr: svc lrs gkb
czr: fgc jhf
sfg: bjm xvd jls
nlv: shl
sdc: kqp shz nkd tqq
gtt: rvb tsb
lhc: rgf kcr pqg
lvq: jmx sft
rtg: nhb jxj
knd: zsr knj hbv xnd
tcm: nfr htr tjm
bgx: fcr
kmp: sfc crs
dqf: prp vsm rrv
mqg: pxg pdc cxz lkm
jnv: cnh xtx xvd qxl
nxs: jcx mnc zdc
jpg: bsm mrs dgr nbs
fpx: crs kbz
hpc: vpf fxx xdt
xbj: hmd bts dcp
flq: ctl
mft: kpj clb tsl gdt
mgm: mzx mcg vgt qgz
kgd: vzn
mbf: pbj zhv hcs
rsg: rdj psv dgx
plc: gbc mkk mnj hpr
zmb: kft pgq xpz pqg
lsd: vqv
nmr: jhz gdv tcq
vjd: blf sxx csd hnj njz lvg
djg: gtt
gkb: zbd
dlk: sgq hvd
tdj: msh lrr cth tqf
xpf: pfd mbf tcb fch
dmd: kmv xpg gjv gjq
htl: zdc fgc
mrv: mpg
zqm: xfs
klf: jgc mjz sfd
ctt: tcq gvf vvx htd
xdb: xpl nlx lkq xpz
psk: rkv mrv scj cvs
tkz: lck
llt: mbz
txq: pqx grk ljs
skx: mmk pns fmj krq
gxn: sjh fsm ltp jxr
rdz: sdj xfs
fgz: bnd bmp tvb fzs
ptq: gng vmz mcj vgr txp
vhr: rcg trv hkj lhz
sbv: psk tqm xfl fdc tfp
zxq: tjg zbd zxs bxf
khh: xkt mrt hvz csx
xfn: hfb vkx ggf jmg
qgp: xxx pgv xnd
hvr: tfx fbk
bdj: nkt bqc hpf gmh
tcq: rhr xrd cps
hmm: mxs mfj dbc pns
bkp: lmb ltl kxz
tqf: xlh
kjt: rxq pzx ckk
dpz: bsq cxq cls zrf hdg qvh
bnp: tjj
nrd: pqq lqx vth
dhz: zfk vvx tpf
kjj: mkq
tmz: lfd
ncq: mkk smd htm ndv
njf: bnr xjp rsm xht
dcl: hsj qjp
ffh: djx ptt vcr mcp
dqg: tqm
npj: kqp blf shq bft
jfd: mxs znk ntb
tsm: gfq vgt sxs gfl
kcd: zkq nsq
fnp: mfh
lcc: pgh fhz bjm
srl: jkm rtg
jkn: kkj
fkf: ffb qtv
bms: sgq lhg pnh
cvs: hvz qbv
tmj: ztx xsp vdh lmr
tpd: hqc jpg zxs txp
zhp: shz
bdt: kbz tjg jzh
mnc: czm mpg
jqv: cfr qxb
jnt: lrd zsm fgc hjc
jpv: qzv bjm zgr hks
tql: hjc
zhv: vlk mxs jfs kkn jgc
zsm: vgp
qvh: gkb
pkq: fgq
dhq: srd qzv
gfb: jxn jqs ssl brb
slv: kdk grx
tqq: zdl dbf
tsr: nlv zdc mxs fxk
gts: qxb zkv
sfs: ttz fcv
kkq: qbz xvb kdh
thm: sdt hsq tgs lfh
xhm: qqc fxg txq vps
xlz: vmx fsm mhv ljs
jxh: tbz ldd chr qdz hhf
nlh: zdc
pfx: fgt rml qrm
ksr: xbt pjz dbf
rrr: dcr vhb vsf kkn
jbf: xfb bvk lhc fkx cjr
csn: xtg chv qmp cph fgr
cvk: dzs bfr ctl rqq
rbs: vkp
nbc: hlh
ppq: hdl qfq rkh jrf dkg gpm
tnz: tfp psk qgz qbv
jhl: dvt
gkg: ffv bht brp kvl
lkn: xtx jbh qff fbx
rxk: dxn zct lvt
qxl: rqx rlf fnp
rgb: vsm
mqv: bft jrg qnl lkr
bpk: vmg zdg dkl
bln: ldh ffv
kfq: qnm
dps: qnm cfr
ztt: jzb vdp gmm
gzn: lpd pgk ngz
jpb: lhg psv
qvg: kzh
vzd: drr
lrx: mbg djx hcq lck kxh
gmm: pxl
psr: rbb nkl
dqj: kxz hjt
hxj: zrd nkl ldh
dsf: zlk cgz
lmj: xjp nxc mgc ckk
kdx: hnk zgt
qhd: nzt nbc
tmd: qmp vsm
qpj: jbg knz
stp: vqb
bts: jlh dzs
vkh: pxz ths cps
xvh: jtc vzn
mbr: ssl qpj jnk
ckq: txt fqv
hvg: ldk qvg zmq xmc lkr xht
ngc: dgr xpj qkj pcd ckq dkk jtf lfd
fsv: lgm
nvr: zsr sbb tvk phx
xvn: fjz nhq cnh
zzx: kdh
gcd: kvr zqk qnh mns
msh: vjs
nbf: nlv nlh knz lmd
jpc: gxg jqv rzg hnk
dsp: txf jdx
cth: qsf mdz
hlq: szv cvb bjr gkj bbn
tvh: mff hpj nnl fss
hvq: ffd kdk
fcr: ctz psm
mzs: kpm lcq rbn jts
bht: kxh
zcz: zdc zgr hxr
qhr: mdg ghf
btt: nrz ndm zhp
szj: qzc bht dkk
tkr: zpr mfh xhl qjp
qtf: kct bqc
mmr: bft
qpz: nbs dsp jdl kfl zgg hbc rbb
kzh: zdl dkl
jsg: nlh lvd qvf mzz fgp
fsl: rbn
snq: tdf jdx
txp: kpn mjv ldk tmd
njl: hvf jzg bnr blg
dvk: xrd msg
flm: rml fgd xkz
vcr: tcq dqj
tld: kbx qzb jqf
kkz: tcm nbc
brd: pfc krn nct mcx czm
bvk: hhf slh
ltv: hhp fgd nhb
msb: rbs dcs dph
lvv: mzx
kmn: mng qkb sfl mvp
stc: rvk mbg bft
psm: fzd
xcj: mdp zbp
ptt: npl
rkh: mck jxr bgx
bkt: cqd
mnr: bpv lhj vrl mbr
nzt: qtb
pmh: rph fjf
vqv: hvd dtm
vkz: dtg
srt: jqf dbg qqs tkd
nnl: tlz fjz hsm
dmg: shl
mnt: dvf vdh tcb
djh: mnc
vlk: nhf
dlx: jkm qds
rcf: lvb cnr lcs zjq
qns: zdh dbc szv trr jct jpf
ggk: qdt lsx
bvc: rsm jqs mgj fhz jvh
dqn: zzx jnt lrz ffd
clb: fsx
zqn: mdp nrv pdf
ddf: qbr gsg jbg
qsm: kvr bcd qff tgb
qxd: pbj vkz cvp kdh
cdd: bhz cbg
mxs: zdh
lgx: hrn scv cns
xzg: mlx gzq
ljs: qqc
jdf: vfc clb fqq vvr spb
lbd: zzl xzk xnn bdn nrv
bjv: cxz scq rcg pkp
jlb: dhq dlx psh mrt cnr
dcr: gbc flq ghc
mch: znk rxk vdj
nrv: bmz cvp